Twe' nkwi xue m'an kwi ti' tyo ndye ts'a ti',	Hubo una vez un zorro	segments_amuzgo-segments_spanish
ts'ian jndë, tyua' ju' sku' ti' k'a ti' jndë,	que trabajaba en el campo, temprano molía su esposa [y] él iba al monte.	segments_amuzgo-segments_spanish
Mo' twe' nkwi xue t-ja ti',	Pero hubo un día	segments_amuzgo-segments_spanish
të ki tsa ti' ts'ian,	que fue al trabajo	segments_amuzgo-segments_spanish
no' ya tje ti' tyua' je,	y cuando llegó más temprano a [su] casa	segments_amuzgo-segments_spanish
t'aa 'nna sku' ti' k'on,	ya no se encontraba su esposa.	segments_amuzgo-segments_spanish
No' ma' kje tats'on ti' ng'e të non tsan nji,	De inmediato se enteró que pasó una persona malvada	segments_amuzgo-segments_spanish
të 'yon jon sku' ti', xue' jon sku' ti'.	que se robó a su esposa.	segments_amuzgo-segments_spanish
No jo,	Entonces	segments_amuzgo-segments_spanish
'nni 'nna ntsa' ti'.	¿qué haría el zorro?	segments_amuzgo-segments_spanish
Ma të kjo ti',	Sólo se sentó	segments_amuzgo-segments_spanish
t'eo ti',	y lloró,	segments_amuzgo-segments_spanish
ndo' hu xjen 'nein tje kwi ki tsian,	(y) en ese momento llegó un tigre,	segments_amuzgo-segments_spanish
tso' ki tsian an':	dijo el tigre:	segments_amuzgo-segments_spanish
ndo' u' tyo ndye re, ndu ma tyo', 'a jo je.	 "y tú amigo zorro, ¿por qué lloras?"	segments_amuzgo-segments_spanish
Ma t'eo ma ng'e	 "Lloro porque	segments_amuzgo-segments_spanish
hu tsan nji tje jon b'a no' tsia na tja jon	la persona malvada llegó a mi casa y cuando se fue	segments_amuzgo-segments_spanish
të 'yon jon sku'.	se llevó a mi esposa".	segments_amuzgo-segments_spanish
No' jo tso ki tsian an': ti' ndyoto	Entonces le dijo el tigre: "no llores	segments_amuzgo-segments_spanish
no' ti'nkon' tonyo ma tson' sku' nein jo kion kwe,	y no te preocupes, tu esposa hoy la voy a ir a traer",	segments_amuzgo-segments_spanish
tso ki tsian an' nnu ti'tyondyee'.	dijo el tigre al zorro.	segments_amuzgo-segments_spanish
Jo jnon ti'	Entonces el zorro	segments_amuzgo-segments_spanish
na' t'ëo' ti'.	dejó de llorar.	segments_amuzgo-segments_spanish
Tja ki tsian ya na tje ki tsianan' b'a tsan nji i',	Fue el tigre a la casa de la persona malvada, cuando llegó a la casa de la persona malvada,	segments_amuzgo-segments_spanish
ya jo tso o' : nkia chjo b'a re, taa 'nna t'a	en ese momento dijo: "vengo a tu casa amigo", no contestó	segments_amuzgo-segments_spanish
tsan nji i' b'i jon.	la persona malvada estaba enojada.	segments_amuzgo-segments_spanish
No' u' re, 'nni 'nna ma ndue' ma nti'.	 "Y tú amigo, ¿qué cosa andas buscando?"	segments_amuzgo-segments_spanish
tsit'uan tson' re, ja njo kwaxye ama yu u' njoyon sku ti'	 "Disculpa amigo, vengo a preguntar si tú en verdad te robaste a la esposa	segments_amuzgo-segments_spanish
sku ti' tyondyee', t'io ti' m'a ti'.	del zorro, el amigo está llorando".	segments_amuzgo-segments_spanish
Ntjo je ki ndye	 "Aquí no puedes	segments_amuzgo-segments_spanish
ntjo je ki ndye nkwaxye nnö', tsan nji b'i jon. 'nni 'nna	preguntar nada", respondió enojada la persona malvada.	segments_amuzgo-segments_spanish
	¿Qué cosa hicieron?	segments_amuzgo-segments_spanish
nja an, tyon tinkia ndhe bi na ya'.	Se agarraron [y] se pegaron.	segments_amuzgo-segments_spanish
Si ki ty'e	El tigre empujó	segments_amuzgo-segments_spanish
ki tsian an' tsan nji i' ni kwe jon tinkia ndhe.	a la persona malvada.	segments_amuzgo-segments_spanish
Ma jo n'ei tëkits'a ki tsian an'.	Nada más eso fue hacer el tigre.	segments_amuzgo-segments_spanish
Ya njo je ta 'nna jndë njo yon ki tsian an',	(Cuando) volvió sin poder traer de regreso	segments_amuzgo-segments_spanish
sku ti' tyondyee',	a la esposa del zorro,	segments_amuzgo-segments_spanish
ndye të 'yon o' to tja o',	(después) se fue y el zorro	segments_amuzgo-segments_spanish
hu ti'tyondye tëkjo nkwe	se sentó otra vez	segments_amuzgo-segments_spanish
ti' tyo ti' mang'e sku ti'	[y] estuvo llorando porque a su mujer	segments_amuzgo-segments_spanish
tsan nji të 'yon jon.	se la había robado una persona malvada.	segments_amuzgo-segments_spanish
Jo tje kwi ki so ndye t'oan tyë' ndye ra.	Entonces llegó una vaca con cuernos grandes y filosos.	segments_amuzgo-segments_spanish
Jo tso ki sondyee'	La vaca le dijo	segments_amuzgo-segments_spanish
u' ndu ma t'ëo' retyondye.	 "¿por qué lloras amigo zorro?"	segments_amuzgo-segments_spanish
	 "¿Por qué no he de llorar? a mi esposa se la llevó	segments_amuzgo-segments_spanish
Ndu ti'ndyio sku' të yon	la persona malvada".	segments_amuzgo-segments_spanish
tsan nji. 'a ndatsu 'a tji ya.	 "¿Estás seguro?"	segments_amuzgo-segments_spanish
Tji ya, mo tanyen tso	 "Estoy seguro".	segments_amuzgo-segments_spanish
	 "(Pero) no importa", dijo	segments_amuzgo-segments_spanish
ki so ndye e' nein jo kio an, tja ro ki sondyee' tje ti'	 "iré hoy a traerla", la vaca se fue [y] cuando la vaca llegó	segments_amuzgo-segments_spanish
m'a tsan nji i' taa b'a' jon b'i jon 'nni 'nna	a la casa de la persona malvada, enojada preguntó "¿qué	segments_amuzgo-segments_spanish
Ma ndue banty'i ntjo.	andas buscando por aquí?"	segments_amuzgo-segments_spanish
Njo tso ki sondyee'	 "Vine -contestó la vaca- porque	segments_amuzgo-segments_spanish
ng'eu' øjno yon sku ti' tyondyee'	tú te llevaste a la esposa del amigo zorro	segments_amuzgo-segments_spanish
no' hu ti' tya ndho ti'.	y él se quedó triste".	segments_amuzgo-segments_spanish
'Nni 'nna nja o' ma' ti' ndhe ra ya	¿Qué hicieron?	segments_amuzgo-segments_spanish
ko ninkiandhe.	Solamente se golpearon.	segments_amuzgo-segments_spanish
Tja nkwe o' m'an tyondyee'.	Después regresó la vaca donde se encontraba el zorro.	segments_amuzgo-segments_spanish
Ta 'nna jndë tyondyere be ndhe	 "No se pudo amigo, nada más	segments_amuzgo-segments_spanish
ti-nkia.	nos pusimos a pelear".	segments_amuzgo-segments_spanish
Jndë je ma' tja ki so ndye e'.	Después de eso se fue la vaca.	segments_amuzgo-segments_spanish
Tyondyee'	El zorro	segments_amuzgo-segments_spanish
ntjo nkwe t'ëo' nkwe ti'.	se quedó triste de nuevo.	segments_amuzgo-segments_spanish
Jo tje kwi tyosu, kio'	Entonces llegó un conejo, un animal	segments_amuzgo-segments_spanish
lu k'en, u' re 'nni 'nna tjon ma t'yeo	pequeño, "tú amigo ¿por qué lloras?",	segments_amuzgo-segments_spanish
'ajo tyosu re, ja ra tso o'	preguntó el conejo.	segments_amuzgo-segments_spanish
sku' të'yon tsan nji no' tsian	 "Lloro porque	segments_amuzgo-segments_spanish
na nein ta'naakokjwe jon ma ni jo	a mi esposa se la llevó una persona malvada	segments_amuzgo-segments_spanish
m'an jon b'a tsan nji.	y todavía no regresa	segments_amuzgo-segments_spanish
Ndye tso tyosu,	de la casa de la persona malvada".	segments_amuzgo-segments_spanish
ja nkjo jo kio an' nein.	 "Mira -dijo el conejo-	segments_amuzgo-segments_spanish
No' jo	iré a traerla hoy".	segments_amuzgo-segments_spanish
tso tyondye jekijndë ntsa'	 "No vas a poder -contestó el zorro-	segments_amuzgo-segments_spanish
re tyosu, jndë tye' n'an na	amigo conejo, ya fueron personas	segments_amuzgo-segments_spanish
t'oan chen mo' ta jndë jnda an',	más grandes y no pudieron".	segments_amuzgo-segments_spanish
'amo' jo 'achi n'amein na tyen be sa na ndha an,	 "Sí, pero ellos nada más fueron a pelear	segments_amuzgo-segments_spanish
tso tyosu nnu tyondyee', tik'o an ng'e tke an	-dijo el conejo al zorro- no van de forma madura	segments_amuzgo-segments_spanish
na ma yu ya ni ts'ian ko'oen.	para hacer un buen trabajo".	segments_amuzgo-segments_spanish
Na nein ja jo, tso tyos u'.	 "Hoy iré", dijo el conejo.	segments_amuzgo-segments_spanish
	Se fue el conejo rumbo a la casa de la persona malvada,	segments_amuzgo-segments_spanish
Tjaro tyosu u' ndo'	cuando llegó	segments_amuzgo-segments_spanish
ya na tje tyosu u' b'a tsan nji	saludó, pero la persona malvada le contestó enojada.	segments_amuzgo-segments_spanish
ndo chjo b'a bi' tso tsan nji ki ndyo jndë je.	Entonces, el conejo dijo "¿por qué eres	segments_amuzgo-segments_spanish
Ya jo, ma junti' tyosu u' tso o'	tan orgullosa en tu casa persona malvada?	segments_amuzgo-segments_spanish
ndu =je u' tsan nji ya ke'tson ba'	Cuando llegas a la casa de alguien	segments_amuzgo-segments_spanish
no' ja nchji ng'e ya na b'a ts'an n-kje	tienes que decirle a la persona que pase y tome asiento	segments_amuzgo-segments_spanish
ntsu nnu ts'an kuenon jon kjo jon	y tú eres muy arrogante", le dijo	segments_amuzgo-segments_spanish
no' u' ji ke' ma tsineinre tso	el conejo a la persona malvada.	segments_amuzgo-segments_spanish
tyosu u' nnu tsan nji.	Después la persona malvada sacó	segments_amuzgo-segments_spanish
Jndë tsan nji i' tji jon	una jícara de agua y se la dio al conejo y [éste]	segments_amuzgo-segments_spanish
Kwi tsua nda ti'jon ndyo tyosu u' jnon	bebió de la bandeja.	segments_amuzgo-segments_spanish
ti' i' tsua ny'ö o'.	Cuando estaba bebiendo,	segments_amuzgo-segments_spanish
Ya na jnon tyosu tsua a' ny'ö o' hu xjen nein	en ese momento, movió las orejas.	segments_amuzgo-segments_spanish
sintsjero o' nonki o'.	Entonces, el conejo llamó	segments_amuzgo-segments_spanish
Jo tuan ro tyosu u'	a la persona malvada.	segments_amuzgo-segments_spanish
u' tsan nji re.	 "¿Es esta agua la que tomas?"	segments_amuzgo-segments_spanish
'Aju nda tio ba ma u'a	 "Sí", contestó la persona malvada.	segments_amuzgo-segments_spanish
	 "No ves que esta agua está muy sucia, ven y mira".	segments_amuzgo-segments_spanish
jo tso tsan nji.	Entonces tomó	segments_amuzgo-segments_spanish
'Atikindia ji ba t'ya jni, kinokindya' yo nön'.	la persona malvada agua de la olla: "en verdad que está sucia el agua".	segments_amuzgo-segments_spanish
Jo tjon	En ese momento	segments_amuzgo-segments_spanish
tsan nji ki xua a': ma yu na t'ya na tio o' .	mandó a la esposa del zorro a traer agua limpia	segments_amuzgo-segments_spanish
Hu xjen 'nein je	hasta el río.	segments_amuzgo-segments_spanish
njon tsan nji sku tyondyee' tëkioo' na tio ntju	El conejo vio hacia donde se fue	segments_amuzgo-segments_spanish
xi' tsjo na m'an tsui' i'.	la persona que mandaron por el agua.	segments_amuzgo-segments_spanish
Ntia' chen tyosu u' tonkio	Después, le dijo el amigo	segments_amuzgo-segments_spanish
Ts'an y'on jon tsjo na nkujon nda.	conejo a la persona malvada, "tú persona malvada, ¿en dónde	segments_amuzgo-segments_spanish
Jo tso ti'	puedo orinar?"	segments_amuzgo-segments_spanish
tyosu nnu tsan nji, u' re tsan nji 'atayujon	 "Ahí mismo párate y orina",	segments_amuzgo-segments_spanish
ya nchiu ts'an jo ro kuendje' n chiu,	le contestó la persona malvada.	segments_amuzgo-segments_spanish
tso tsan nji.	Entonces,	segments_amuzgo-segments_spanish
Jo tju tyosu u', kwi tekeno'	saltó el conejo, volteó,	segments_amuzgo-segments_spanish
xi' ta'ndia tsan nji	en el momento en el que no estaba viendo la persona malvada,	segments_amuzgo-segments_spanish
tju ro, kwi chen jon tontk'on tja ro o.	saltó otra vez, giró y se fue.	segments_amuzgo-segments_spanish
Ya tje o' xi' tsjoo'	Llegó hasta el rio	segments_amuzgo-segments_spanish
jo chen m'an sku tyondyee', ma' hu xjen 'nein tyon	donde se encontraba la esposa del zorro, en ese momento agarró	segments_amuzgo-segments_spanish
tyosu u' tsjo tju ndo'	la olla el conejo y la tiró,	segments_amuzgo-segments_spanish
ma' sk'a ndyö o' ti' sku	tomó con la mano a la esposa del amigo	segments_amuzgo-segments_spanish
tyo ndye e' tyo o' styo ti' njoyoro ti' tje	zorro, se la puso en su cuello y se la llevó.	segments_amuzgo-segments_spanish
ndjayu.	Llegó	segments_amuzgo-segments_spanish
No' ya tje ti'	(y cuando llegó)	segments_amuzgo-segments_spanish
b'a jndë tje re tyondye, ndo'	a la casa del amigo zorro	segments_amuzgo-segments_spanish
sku' njoyon jndë njokini'i nnu ndoba na nkja ts'an	 "te traje a tu esposa, así es como se hace un buen trabajo,	segments_amuzgo-segments_spanish
ndya tke nkja ts'an, tobe nkja tsindha ts'an.	tienes que ir de manera madura, no a pelear.	segments_amuzgo-segments_spanish
	Aquí está tu esposa".	segments_amuzgo-segments_spanish
Ndo' sku'.	 "Gracias".	segments_amuzgo-segments_spanish
Nkianaya u' ndo', jndë ma' jo tjaro tyosu je.	 "Ya me voy, pues", [y] se fue el conejo.	segments_amuzgo-segments_spanish
